11111111111111111111111111111111111111111111111111111111111111111
11111111111111111111111111111111111111111111111111111111111111111
100000000000000000000000000000000000000000000000000000000000000E1
10000000000000000000000000000000000000000C00000000000000000000001
10000000000000000001100000000000111111111110000000000000000000001
10000000000000000011000000000000000000000110000000000000000000001
100000000000000001100C0011000000000000000110000000000000000000001
10000000000000001111111111000000000000000110000000000000000000001
10000000000000000000000011000000011111111110000000000000000000001
10000000000000000000000011000000011000000000000000000000000C00001
10000000000000000000000011000000011C00000000000000000000000000001
10000000000000000000000011000000011111111111000000000000000000001
10000000000C00000000000000000000000000000000000000000000000000001
1P000000000000000000000000000000000000000000000000000000000000001
11111111111111111111111111111111111111111111111111111111111111111
11111111111111111111111111111111111111111111111111111111111111111