111111111
1C0000001
100110011
1P00001E1
111111111