111111111
1C1000001
111110001
1P00000E1
111111111