111111111
1C0000001
1001100011
1P00000E111
111111111111