111111111
1C0000001
100110001
1000000E1
111111111