111111111
1C0000001
110110001
1P10000E1
111111111