111111111
1C0000001
100110001
1P0000001
111111111