111111101
1C0000001
100110001
1P00000E1
111111111