1111111111111111
10010000000C0011
1000011111000011
1P0000000E000011
1111111111111111