1111111111111111
10010000000C0011
1000011111000011
1P00000C00000E11
1111111111111111