1111111111111111
10010000000C0001
1000011111000001
1P00000C00000E01
1111111111111111